wwwwwwwwwwwwwwwwwwww
w-p-*--*-www-*-----w
w---**--**-----*---w
w------**--**---***w
w----wwwwwwwww-----w
w------------------w
wwwww---------wwwwww
w------www---------w
w----***-----**----w
w---wwwwwwwwwwwww--w
w------****---&----w
wwwwwwwwwwwwwwwwwwww
